R 1920 1080
NO ./srcs/ressources/mossy.xpm
SO ./srcs/ressources/colorstone.xpm
WE ./srcs/ressources/greystone.xpm
EA ./srcs/ressources/bluestone.xpm
F 200,95,252
C 255, 20,255
S ./srcs/ressources/barrel.xpm


111111111111111111111 
100000000000000000001
101100111110000000001
101000100100201000001
101000102010000010001
100000100000000010001
100000111110000011111
100200000000000010001
100000000000020000W01
111111111111111111111
